xxxxxxxxxxxxxxxxx
x0b000b000b000b0x
x000000000000000x
x000000000000000x
x002222000222200x
x0dddb60006bddd0x
x0dsd0600060dsd0x
x0dddd66666dddd0x
x000033333330000x
x00004s444s40000x
x0000555l5550000x
x20004s444s40002x
x120033333330021x
x012000000000210x
x001200000002100x
x000122222221000x
x000011111110000x
x000000000000000x
x000000000000000x
x000000000000000x
x000000000000000x
x000000000000000x
x000000000000000x
x000000000000000x
x000000000000000x