xxxxxxxxxxxxxxxxx
xllxbxx1b1xxbxllx
x63x0xx101xx0x36x
x63x0xx1s1xx0x36x
x63d24x111x42d36x
x63d24x111x42d36x
x63d24xdddx42d36x
x63d240000042d36x
x63d240000042d36x
x63ds4000004sd36x
xddd440000044dddx
x000000000000000x
x0000123456d0000x
x0000d6543210000x
x000000000000000x
x2s20000000002s2x
xxxxx0000000xxxxx
x000000000000000x
x000000000000000x
x000000000000000x
x000000000000000x
x000000000000000x
x000000000000000x
x000000000000000x
x000000000000000x