xxxxxxxxxxxxxxxxx
xsd00000000000dsx
xdd00000200000ddx
x0000002s2000000x
x000002b3b200000x
x002221030122200x
x000211545112000x
x000023343320000x
x0b000244420000bx
x000002333200000x
x0000265l5620000x
xdd02662226620ddx
x002ss20002ss200x
xdd22200000222ddx
x000000ddd000000x
xdd000d000d000ddx
x000000000000000x
xdd00000000000ddx
x000000000000000x
x000000000000000x
x000000000000000x
x000000000000000x
x000000000000000x
x000000000000000x
x000000000000000x